1111111111111
1MC0P000000E1
1111111111111
