11111111
1PC00001
1MC00001
101010E1
11111111
