11111111111111111111111111111111
10P00000000001100000000000000011
10111101111001101111101111110111
10000001000000000000001000000111
100C0000111111011111100111100011
10111000000000100000000000000111
10001000111110101111110111110111
10C0000000000000M000000000000011
10111110111110111110111111111111
10000000100000000000000000000011
11110111101111111101111011111011
10M0000000000000C00000000000E111
10000011111110111111101111110111
10111000000000000000000000000111
10000000001111110111111000000111
11111110000000000000000000111111
11111111111111111111111111111111
