111111111111111111
100P0000C000000001
10000000001000E011
10000000M000000001
10000000M000000001
10000000M000000001
10000000M000000001
10000000M000000001
10000000M000000001
111111111111111111